** Subreddit Name -> Folder Name **
adorableporn -> Adorable Porn
AsianHotties -> Asian Hotties
AsiansGoneWild -> Asians Gone Wild
bbyPocahontas -> u/bbyPocahontas
BiggerThanYouThought -> Bigger Than You Thought
bodyperfection -> Body Perfection
Boobies -> Boobies
BustyPetite -> Busty Petite
gettingherselfoff -> Getting herself off
GirlsFinishingTheJob -> Girls Finishing the Job
goddesses -> Goddesses
GodPussy -> Godpussy
gonewild -> Gone Wild
GWCouples -> Gone Wild Couples
IAmABadIdea -> u/IAmABadIdea
LipsThatGrip -> Lips That Grip
nsfw -> NSFW
NSFWFunny -> NSFW Funny
rule34 -> Rule 34
Rule34Overwatch -> Overwatch
PetiteGoneWild -> Petite Gone Wild
porninfifteenseconds -> Porn in Fifteen Seconds
pussy -> Pussy
RealGirls -> Real Girls
Rule34LoL -> League
thighhighs -> Thighhighs
ur2dwaifu_ -> u/ur2dwaifu_
whenitgoesin -> WhenItGoesIn
yourkoreanbabygirl -> u/yourkoreanbabygirl